In the distance, you hear a woman's voice. It's so loud that it woke you up. You feel stiff and tired, as if you hadn't slept at all. A small window above the bed is the only source of light in an otherwise completely dark room. You're not afraid of the dark-on the contrary, you find it comforting. You decide to head toward the woman's voice.

Garage
A place where you spend your nights resting. Below the window, there is a bed without a pillow. The only exit is a brown door to the north.

[Welcome to Vorple!]

What is your name?

>Eugen
Hi, Eugen!

In the distance, you hear a woman's voice. It's so loud that it woke you up. You feel stiff and tired, as if you hadn't slept at all. A small window above the bed is the only source of light in an otherwise completely dark room. You're not afraid of the dark-on the contrary, you find it comforting. You decide to head toward the woman's voice.

Garage
A place where you spend your nights resting. Below the window, there is a bed without a pillow. The only exit is a brown door to the north.

* * *

In the distance, you hear a woman's voice. It's so loud that it woke you up. You feel stiff and tired, as if you hadn't slept at all. A small window above the bed is the only source of light in an otherwise completely dark room. You're not afraid of the dark-on the contrary, you find it comforting. You decide to head toward the woman's voice.

Garage
A place where you spend your nights resting. Below the window, there is a bed without a pillow. The only exit is a brown door to the north.

[Welcome to Vorple!]

What is your name?

>look
Garage
A place where you spend your nights resting. Below the window, there is a bed without a pillow. The only exit is a brown door to the north.

>examine
(the brown door)
You see nothing special about the brown door.

>n
(first opening the brown door)

Kitchen
Here I always get something to eat, but I'm not always welcome. A dangerous pit with spikes blocks the way to the east.

You can see a rope and a bone here.

>examine
What do you want to examine?

>rope
This will come in handy.

>version
9Zivota
An Interactive Fiction by Andrej
Release 1 / Serial number 250416 / Inform 7 v10.1.2 / D
Inform 7 v10.1.2
Identification number: //CAD75681-8B0E-4B24-A7CB-B9DE639CDA8D//
Interpreter version 0.6.0 / VM 3.1.3

* * *

In the distance, you hear a woman's voice. It's so loud that it woke you up. You feel stiff and tired, as if you hadn't slept at all. A small window above the bed is the only source of light in an otherwise completely dark room. You're not afraid of the dark-on the contrary, you find it comforting. You decide to head toward the woman's voice.

Garage
A place where you spend your nights resting. Below the window, there is a bed without a pillow. The only exit is a brown door to the north.

[Welcome to Vorple!]

What is your name?

>n
(first opening the brown door)

Kitchen
Here I always get something to eat, but I'm not always welcome. A dangerous pit with spikes blocks the way to the east.

You can see Rope and a bone here.

>e
Ne mogu ovo preskočiti, ali se mogu zanjihati preko s nečim.

YOU DIED

Kitchen
Here I always get something to eat, but I'm not always welcome. A dangerous pit with spikes blocks the way to the east.

You can see Konopac here.

>e
I can't jump over this, but I can swing across with something.

>e
I can't jump over this, but I can swing across with something.

>e
I can't jump over this, but I can swing across with something.
You are out of lives!

    *** GAME OVER ***

Would you like to RESTART, RESTORE a saved game, QUIT or UNDO the last command?

* * *

>e
I can't jump over this, but I can swing across with something.

>ee
That's not a verb I recognise.

>w
You can't go that way.

>w
You can't go that way.

>e
I can't jump over this, but I can swing across with something.

I beg your pardon?

I beg your pardon?

>ee
That's not a verb I recognise.

>e
I can't jump over this, but I can swing across with something.
You are out of lives!

    *** GAME OVER ***

Would you like to RESTART, RESTORE a saved game, QUIT or UNDO the last command?

* * *

>e
Ne mogu ovo preskočiti, ali se mogu zanjihati preko s nečim.

YOU DIED

Kitchen
Here I always get something to eat, but I'm not always welcome. A dangerous pit with spikes blocks the way to the east.

You can see Konopac here.

>look
Hallway
A cold and long hallway that leads to the basement.

* * *

>e
Ne mogu ovo preskočiti, ali se mogu zanjihati preko s nečim.

YOU DIED

Kitchen
Here I always get something to eat, but I'm not always welcome. A dangerous pit with spikes blocks the way to the east.

You can see Konopac here.

>w
You can't go that way.

* * *

>ee
That's not a verb I recognise.

>e
I can't jump over this, but I can swing across with something.

* * *

>w
You can't go that way.

>i
You are carrying nothing.

* * *

>n
(first opening the brown door)

Kitchen
Here I always get something to eat, but I'm not always welcome. A dangerous pit with spikes blocks the way to the east.

You can see Rope and a bone here.

>look
Kitchen
Here I always get something to eat, but I'm not always welcome. A dangerous pit with spikes blocks the way to the east.

>take konopac
You can't see any such thing.

* * *

>n
(first opening the brown door)

Kitchen
Here I always get something to eat, but I'm not always welcome. A dangerous pit with spikes blocks the way to the east.

You can see Rope and a bone here.

>take bone
Taken.

>take rope
You're carrying too many things already.

>drop
(the bone)
Dropped.

>take konopac
You can't see any such thing.

>take rope
Taken.

>take bone
You're carrying too many things already.

>i
You are carrying:
  a rope

* * *

>n
(first opening the brown door)

Kitchen
Here I always get something to eat, but I'm not always welcome. A dangerous pit with spikes blocks the way to the east.

You can see Rope and a bone here.

>take konopac
Taken.

>wear konopac
You put on Konopac.

>e
Ne mogu ovo preskočiti, ali se mogu zanjihati preko s nečim.
Uspio sam! Ovaj konopac će mi dobro doći i na povratku.

Hallway
A cold and long hallway that leads to the basement.

>w
Ne mogu ovo preskočiti, ali se mogu zanjihati preko s nečim.
Uspio sam! Ovaj konopac će mi dobro doći i na povratku.

Kitchen
Here I always get something to eat, but I'm not always welcome. A dangerous pit with spikes blocks the way to the east.

>s
Garage
A place where you spend your nights resting. Below the window, there is a bed without a pillow. The only exit is a brown door to the north.

>drop
(Konopac)
(first taking Konopac off)
Dropped.

>i
You are carrying nothing.

>n
Kitchen
Here I always get something to eat, but I'm not always welcome. A dangerous pit with spikes blocks the way to the east.

>e
Ne mogu ovo preskočiti, ali se mogu zanjihati preko s nečim.

YOU DIED
Kitchen
Here I always get something to eat, but I'm not always welcome. A dangerous pit with spikes blocks the way to the east.

* * *

>n
(first opening the brown door)

Kitchen
Here I always get something to eat, but I'm not always welcome. A dangerous pit with spikes blocks the way to the east.

You can see Rope and a bone here.

>take rope
Taken.

>i
You are carrying:
  Rope